1111111111111111111
1000010000100000001
1001000000100000001
10010P0110000000E01
1000000000100000001
100C011000100000001
1000010000100000001
100C001000000000001
1111111111111111111
