1111111111111111111
100000000A000000001
10000000000000A0001
100000000A000000001
1000000000000000001
1000A00001000000001
1000000000000000E01
100A00A01P10A00A001
1000000001000000001
100000000000A000001
100000A00A000000001
100000C000000000001
100000000A000000001
1111111111111111111
